##CUSTOM##
alias a='alias'
alias df='df -H'
alias du='du -chd 1'
alias h='history' 
alias j='jobs -l' 
alias l='ls -Fb' 
alias la='ls -abFl' 
alias ld="ls -ld"
alias ll='ls -abFl' 
alias lt='ls -At1 && echo "------Oldest--"'
alias ltr='ls -Art1 && echo "------Newest--"'
alias m='less' 
alias ot='popd' 
alias tf='tail -25 -f'
alias to='pushd' 
alias zm='zless'

#GIT
alias ga='git add'
alias gb='git branch'
alias gc='git commit'
alias gca='git commit -a -m'
alias gcm='git commit -m'
alias gd='git diff'
alias gk='gitk --all&'
alias gl='git log --all --decorate --graph --oneline'
alias go='git checkout'
alias gs='git status'
alias gx='gitx --all'

#TASK
alias t='task'
alias ta='task add'
alias tb='task burndown'
alias tbd='task burndown.daily'
alias tbm='task burndown.monthly'
alias tg='task ghistory'
alias tga='task ghistory.annual'
alias th='task history'
alias tha='task history.annual'
alias tl='task log'
alias tla='task all'
alias tlc='task complete'
alias tls='task list'
alias ts='task timesheet'
####

